{
  "name": "index",
  "displayName": "3. emelet",
  "color": "#FFFFFF",
  "foreground": [
    ".....................................................................",
    ".....................................................................",
    ".....................................................................",
    "..#################################################################..",
    "..#.......#.......#.......#.......#.......#.......#.......#.......#..",
    "..#.......#.......#.......#.......#.......#.......#.......#.......#..",
    "..#.......#.......#.......#.......#.......#.......#.......#.......#..",
    "..#.......#.......#.......#.......#.......#.......#.......#.......#..",
    "..#.......#.......#.......#.......#.......#.......#.......#.......#..",
    "..#.......#.......#.......#.......#.......#.......#.......#.......#..",
    "..#.......#.......#.......#.......#.......#.......#.......#.......#..",
    "..#.......#.......#.......#.......#.......#.......#.......#.......#..",
    "..#.......#.......#.......#.......#.......#.......#.......#.......#..",
    "..##..#########..###..#########..###..#########..###..#########..##..",
    "..#...#...#...#...#...#...#...#...#...#...#...#...#...#...#...#...#..",
    "..#...#...#...#...#...#...#...#...#...#...#...#...#...#...#...#...#..",
    "..#...|...#...|...#...|...#...|...#...|...#...|...#...|...#...|...#..",
    "..#...#...#...#...#...#...#...#...#...#...#...#...#...#...#...#...#..",
    "...#..#########-#####-#########-#####-#########-#####-#########..#...",
    "..#....|..........................|..........................|....#..",
    "..#....#..........................|..........................#....#..",
    "..##################...#######################...##################..",
    ".......#....#....|.....#######################.....|....#....#.......",
    ".......#..#####..###...###........#........###...###..#####..#.......",
    ".......#.........#..#..###........#........###..#..#.........#.......",
    ".....################..###........#........###..################.....",
    ".....#.........#....#..######--#######--######..#....#.........#.....",
    ".....#..............#..#.....................#..#..............#.....",
    ".....#..............|..|.....................|..|..............#.....",
    ".....#.........###-##..|.....................|..##-###.........#.....",
    ".....#.........#....#..|.....................|..#....#.........#.....",
    ".....#.........#....#..#.....................#..#....#.........#.....",
    ".....#.........#....#..######--#######--######..#....#.........#.....",
    ".....################..####......###......####..################.....",
    ".....#.........#....#..####......###......####..#....#.........#.....",
    ".....#.........#....#..####......###......####..#....#.........#.....",
    ".....#.........#....#..#######################..#....#.........#.....",
    ".....#.........###-##..#..........#..........#..##-###.........#.....",
    ".....#..............|..#..........#..........#..|..............#.....",
    ".....#..............#..#######################..#..............#.....",
    ".....#.........#....#..#......#...#...#......#..#....#.........#.....",
    ".....################..|......|...#...|......|..################.....",
    ".....#.........#....#..#......#...#...#......#..#....#.........#.....",
    ".....#..............#..#######################..#..............#.....",
    ".....#..............|..#..........#..........#..|..............#.....",
    ".....#.........###-##..#..........#..........#..##-###.........#.....",
    ".....#.........#....#..###--#############--###..#....#.........#.....",
    ".....#.........#....#.............|.............#....#.........#.....",
    ".....#.........#....#..#..........#..........#..#....#.........#.....",
    ".....################..#######################..################.....",
    ".....#.........#....#..#..........#..........#..#....#.........#.....",
    ".....#.........#....#..#..........#..........#..#....#.........#.....",
    ".....#.........#....#..#..........#..........#..#....#.........#.....",
    ".....#.........###-##..#..........#..........#..##-###.........#.....",
    ".....#..............|..#..........#..........#..|..............#.....",
    ".....#..............#..#..........#..........#..#..............#.....",
    ".....#.........#....#..#..........#..........#..#....#.........#.....",
    ".....################..#..........#..........#..################.....",
    "...............#.......|..........#..........|.......#...............",
    "...............######-##..........#..........##-######...............",
    "...............#.......#..........#..........#.......#...............",
    "...............#.......#######################.......#...............",
    "...............#.......#.....................#.......#...............",
    "...............#.......#.....................#.......#...............",
    "...............#########.....................#########...............",
    ".....................................................................",
    ".....................................................................",
    ".....................................................................",
    "....................................................................."
  ],
  "teleportRegions": [
    {"x": 10, "y": 2, "target": "lvl0", "targetX": 20, "targetY":  20}
  ]
}
